NO ./path_to_the_north_texture
SO ./path_to_the_south_texture
F patatata
C 225,30,0
WE ./path_to_the_west_texture
EA ./path_to_the_east_texture



        1111111111111111111111111
        1000000000110000000000001
        1011001001110000000000001            
        10010010000000000000000011
1111111101100000111000000000000001                      
1000000000011000001110111111111111                     
11110111111111011100000010001                           
11110111111111011101010010001
11000000110101011100000010001
10000000000010001100000010001
10000000000000001101010010N01
1100000111010101111101111000111
11110111 1110101 101111010001
11110111 1111111 111111111111
11111111